GNU bash, version 3.2.57(1)-release (x86_64-apple-darwin15)
Copyright (C) 2007 Free Software Foundation, Inc.
bash: no job control in this shell
bash-3.2$ python tryagain.py
http://www.sg.unicamp.br/pautas/ata67consu.pdfhttp://www.sg.unicamp.br/pautas/ata5extraconsu.pdfhttp://www.sg.unicamp.br/pautas/pautaconsu3extra2001.pdfhttp://www.sg.unicamp.br/pautas/atapossereitor.pdfhttp://www.sg.unicamp.br/pautas/pautaconsu76v2.pdfhttp://www.sg.unicamp.br/pautas/ata80consu.pdfhttp://www.sg.unicamp.br/pautas/pautaconsu86vol1.pdfhttp://www.sg.unicamp.br/pautas/pauta6extraconsu2005.pdfhttp://www.sg.unicamp.br/pautas/ata94consu.pdfhttp://www.sg.unicamp.br/pautas/pauta95consuvol1.pdfhttp://www.sg.unicamp.br/pautas/pauta93consuvol2.pdfhttp://www.sg.unicamp.br/pautas/ata91consu.pdfhttp://www.sg.unicamp.br/pautas/ataprêmiozeferinovaz2004.pdfhttp://www.sg.unicamp.br/pautas/pauta100consuadendo.pdfhttp://www.sg.unicamp.br/pautas/pauta99consuvol2.pdfhttp://www.sg.unicamp.br/pautas/pauta96consu.pdfhttp://www.sg.unicamp.br/pautas/pautaconsu2extra07supl.pdfhttp://www.sg.unicamp.br/pautas/pauta101consuadendo2.pdfhttp://www.sg.unicamp.br/pautas/ata109consu.pdfhttp://www.sg.unicamp.br/pautas/Pauta108consu_OD-Exp_VolumeII.pdfhttp://www.sg.unicamp.br/pautas/pauta106consu.pdfhttp://www.sg.unicamp.br/consu/pautas-e-atas/ano-2009http://www.sg.unicamp.br/pautas/p2010/consu/pautaconsu2extra-supl.pdfhttp://www.sg.unicamp.br/pautas/p2010/consu/ataconsu3extra2009.pdfhttp://www.sg.unicamp.br/pautas/p2010/consu/pautaconsu116OrdemdoDiaVol.II.pdfhttp://www.sg.unicamp.br/consu/pautas-e-atas/ano-2011http://www.sg.unicamp.br/consu/pautas-e-atas/ano-2012http://www.sg.unicamp.br/pautas/p2013/consu/133/ata-132.pdfhttp://www.sg.unicamp.br/pautas/p2013/consu/131/ata-reconhecimento-docente.pdfhttp://www.sg.unicamp.br/pautas/convenios/i2014/consu/140/distribuido-no-inicio-da-sessao.pdfhttp://www.sg.unicamp.br/pautas/p2014/consu/139/ata-1-extraordinaria.pdfhttp://www.sg.unicamp.br/pautas/p2014/consu/138/ata-doutor-honoris-causa-ettore-finazzi-agro.pdfhttp://www.sg.unicamp.br/pautas/p2014/consu/137/pauta-137.pdfhttp://www.sg.unicamp.br/pautas/p2015/consu/142/pauta-142.pdfhttp://www.sg.unicamp.br/pautas/pautaextraconsu5.pdfhttp://www.sg.unicamp.br/pautas/pautaconsu65.pdfhttp://www.sg.unicamp.br/pautas/pauta64consu.pdfhttp://www.sg.unicamp.br/pautas/ata4aextraconsu99.pdfhttp://www.sg.unicamp.br/pautas/AtaProfEmerito_Newton.pdfhttp://www.sg.unicamp.br/pautas/ata112consu.pdfhttp://www.sg.unicamp.br/pautas/ataconsu_1extra2009.pdfhttp://www.sg.unicamp.br/pautas/ataconsu_Posse-Fernando-Costa.pdfhttp://www.sg.unicamp.br/pautas/pautaconsu112_Ordemdodia-Volume_2.pdfhttp://www.sg.unicamp.br/pautas/p2011/consu/125/pauta125.pdfhttp://www.sg.unicamp.br/pautas/p2011/consu/124/ata123.pdfhttp://www.sg.unicamp.br/pautas/p2011/consu/1-extra/pauta1extra.pdfhttp://www.sg.unicamp.br/pautas/p2012/consu/4-extraordinaria/pauta-4-extraordinaria.pdfhttp://www.sg.unicamp.br/pautas/p2012/consu/128/ata-127.pdfhttp://www.sg.unicamp.br/pautas/p2012/consu/126/ata-2-sessao-extraordinaria.pdf
bash-3.2$ tryagain.py
bash: tryagain.py: command not found
bash-3.2$ python tryagain.py
  File "tryagain.py", line 6
    print links.split(.pdf)
                      ^
SyntaxError: invalid syntax
bash-3.2$ python tryagain
python: can't open file 'tryagain': [Errno 2] No such file or directory
bash-3.2$ python tryagain.py
['http://www.sg.unicamp.br/pautas/ata67consu', 'http://www.sg.unicamp.br/pautas/ata5extraconsu', 'http://www.sg.unicamp.br/pautas/pautaconsu3extra2001', 'http://www.sg.unicamp.br/pautas/atapossereitor', 'http://www.sg.unicamp.br/pautas/pautaconsu76v2', 'http://www.sg.unicamp.br/pautas/ata80consu', 'http://www.sg.unicamp.br/pautas/pautaconsu86vol1', 'http://www.sg.unicamp.br/pautas/pauta6extraconsu2005', 'http://www.sg.unicamp.br/pautas/ata94consu', 'http://www.sg.unicamp.br/pautas/pauta95consuvol1', 'http://www.sg.unicamp.br/pautas/pauta93consuvol2', 'http://www.sg.unicamp.br/pautas/ata91consu', 'http://www.sg.unicamp.br/pautas/atapr\xc3\xaamiozeferinovaz2004', 'http://www.sg.unicamp.br/pautas/pauta100consuadendo', 'http://www.sg.unicamp.br/pautas/pauta99consuvol2', 'http://www.sg.unicamp.br/pautas/pauta96consu', 'http://www.sg.unicamp.br/pautas/pautaconsu2extra07supl', 'http://www.sg.unicamp.br/pautas/pauta101consuadendo2', 'http://www.sg.unicamp.br/pautas/ata109consu', 'http://www.sg.unicamp.br/pautas/Pauta108consu_OD-Exp_VolumeII', 'http://www.sg.unicamp.br/pautas/pauta106consu', 'http://www.sg.unicamp.br/consu/pautas-e-atas/ano-2009http://www.sg.unicamp.br/pautas/p2010/consu/pautaconsu2extra-supl', 'http://www.sg.unicamp.br/pautas/p2010/consu/ataconsu3extra2009', 'http://www.sg.unicamp.br/pautas/p2010/consu/pautaconsu116OrdemdoDiaVol.II', 'http://www.sg.unicamp.br/consu/pautas-e-atas/ano-2011http://www.sg.unicamp.br/consu/pautas-e-atas/ano-2012http://www.sg.unicamp.br/pautas/p2013/consu/133/ata-132', 'http://www.sg.unicamp.br/pautas/p2013/consu/131/ata-reconhecimento-docente', 'http://www.sg.unicamp.br/pautas/convenios/i2014/consu/140/distribuido-no-inicio-da-sessao', 'http://www.sg.unicamp.br/pautas/p2014/consu/139/ata-1-extraordinaria', 'http://www.sg.unicamp.br/pautas/p2014/consu/138/ata-doutor-honoris-causa-ettore-finazzi-agro', 'http://www.sg.unicamp.br/pautas/p2014/consu/137/pauta-137', 'http://www.sg.unicamp.br/pautas/p2015/consu/142/pauta-142', 'http://www.sg.unicamp.br/pautas/pautaextraconsu5', 'http://www.sg.unicamp.br/pautas/pautaconsu65', 'http://www.sg.unicamp.br/pautas/pauta64consu', 'http://www.sg.unicamp.br/pautas/ata4aextraconsu99', 'http://www.sg.unicamp.br/pautas/AtaProfEmerito_Newton', 'http://www.sg.unicamp.br/pautas/ata112consu', 'http://www.sg.unicamp.br/pautas/ataconsu_1extra2009', 'http://www.sg.unicamp.br/pautas/ataconsu_Posse-Fernando-Costa', 'http://www.sg.unicamp.br/pautas/pautaconsu112_Ordemdodia-Volume_2', 'http://www.sg.unicamp.br/pautas/p2011/consu/125/pauta125', 'http://www.sg.unicamp.br/pautas/p2011/consu/124/ata123', 'http://www.sg.unicamp.br/pautas/p2011/consu/1-extra/pauta1extra', 'http://www.sg.unicamp.br/pautas/p2012/consu/4-extraordinaria/pauta-4-extraordinaria', 'http://www.sg.unicamp.br/pautas/p2012/consu/128/ata-127', 'http://www.sg.unicamp.br/pautas/p2012/consu/126/ata-2-sessao-extraordinaria', '']
bash-3.2$ python tryagain.py
['http://www.sg.unicamp.br/pautas/ata67consu.pdf', 'http://www.sg.unicamp.br/pautas/ata5extraconsu.pdf', 'http://www.sg.unicamp.br/pautas/pautaconsu3extra2001.pdf', 'http://www.sg.unicamp.br/pautas/atapossereitor.pdf', 'http://www.sg.unicamp.br/pautas/pautaconsu76v2.pdf', 'http://www.sg.unicamp.br/pautas/ata80consu.pdf', 'http://www.sg.unicamp.br/pautas/pautaconsu86vol1.pdf', 'http://www.sg.unicamp.br/pautas/pauta6extraconsu2005.pdf', 'http://www.sg.unicamp.br/pautas/ata94consu.pdf', 'http://www.sg.unicamp.br/pautas/pauta95consuvol1.pdf', 'http://www.sg.unicamp.br/pautas/pauta93consuvol2.pdf', 'http://www.sg.unicamp.br/pautas/ata91consu.pdf', 'http://www.sg.unicamp.br/pautas/atapr\xc3\xaamiozeferinovaz2004.pdf', 'http://www.sg.unicamp.br/pautas/pauta100consuadendo.pdf', 'http://www.sg.unicamp.br/pautas/pauta99consuvol2.pdf', 'http://www.sg.unicamp.br/pautas/pauta96consu.pdf', 'http://www.sg.unicamp.br/pautas/pautaconsu2extra07supl.pdf', 'http://www.sg.unicamp.br/pautas/pauta101consuadendo2.pdf', 'http://www.sg.unicamp.br/pautas/ata109consu.pdf', 'http://www.sg.unicamp.br/pautas/Pauta108consu_OD-Exp_VolumeII.pdf', 'http://www.sg.unicamp.br/pautas/pauta106consu.pdf', 'http://www.sg.unicamp.br/consu/pautas-e-atas/ano-2009http://www.sg.unicamp.br/pautas/p2010/consu/pautaconsu2extra-supl.pdf', 'http://www.sg.unicamp.br/pautas/p2010/consu/ataconsu3extra2009.pdf', 'http://www.sg.unicamp.br/pautas/p2010/consu/pautaconsu116OrdemdoDiaVol.II.pdf', 'http://www.sg.unicamp.br/consu/pautas-e-atas/ano-2011http://www.sg.unicamp.br/consu/pautas-e-atas/ano-2012http://www.sg.unicamp.br/pautas/p2013/consu/133/ata-132.pdf', 'http://www.sg.unicamp.br/pautas/p2013/consu/131/ata-reconhecimento-docente.pdf', 'http://www.sg.unicamp.br/pautas/convenios/i2014/consu/140/distribuido-no-inicio-da-sessao.pdf', 'http://www.sg.unicamp.br/pautas/p2014/consu/139/ata-1-extraordinaria.pdf', 'http://www.sg.unicamp.br/pautas/p2014/consu/138/ata-doutor-honoris-causa-ettore-finazzi-agro.pdf', 'http://www.sg.unicamp.br/pautas/p2014/consu/137/pauta-137.pdf', 'http://www.sg.unicamp.br/pautas/p2015/consu/142/pauta-142.pdf', 'http://www.sg.unicamp.br/pautas/pautaextraconsu5.pdf', 'http://www.sg.unicamp.br/pautas/pautaconsu65.pdf', 'http://www.sg.unicamp.br/pautas/pauta64consu.pdf', 'http://www.sg.unicamp.br/pautas/ata4aextraconsu99.pdf', 'http://www.sg.unicamp.br/pautas/AtaProfEmerito_Newton.pdf', 'http://www.sg.unicamp.br/pautas/ata112consu.pdf', 'http://www.sg.unicamp.br/pautas/ataconsu_1extra2009.pdf', 'http://www.sg.unicamp.br/pautas/ataconsu_Posse-Fernando-Costa.pdf', 'http://www.sg.unicamp.br/pautas/pautaconsu112_Ordemdodia-Volume_2.pdf', 'http://www.sg.unicamp.br/pautas/p2011/consu/125/pauta125.pdf', 'http://www.sg.unicamp.br/pautas/p2011/consu/124/ata123.pdf', 'http://www.sg.unicamp.br/pautas/p2011/consu/1-extra/pauta1extra.pdf', 'http://www.sg.unicamp.br/pautas/p2012/consu/4-extraordinaria/pauta-4-extraordinaria.pdf', 'http://www.sg.unicamp.br/pautas/p2012/consu/128/ata-127.pdf', 'http://www.sg.unicamp.br/pautas/p2012/consu/126/ata-2-sessao-extraordinaria.pdf', '.pdf']
bash-3.2$ python tryagain.py
Traceback (most recent call last):
  File "tryagain.py", line 11, in <module>
    import downloadall as down
  File "/Users/Admin/Desktop/T U /Teste/transparenciaunicamp-data/Consu/downloadall.py", line 31
    pdf = for url in parser.urls:
            ^
SyntaxError: invalid syntax
bash-3.2$ python tryagain.py
Traceback (most recent call last):
  File "tryagain.py", line 11, in <module>
    import downloadall as down
  File "/Users/Admin/Desktop/T U /Teste/transparenciaunicamp-data/Consu/downloadall.py", line 31
    pdf = for url in parser.urls:
            ^
SyntaxError: invalid syntax
bash-3.2$ python tryagain.py
Traceback (most recent call last):
  File "tryagain.py", line 11, in <module>
    import downloadall as down
  File "/Users/Admin/Desktop/T U /Teste/transparenciaunicamp-data/Consu/downloadall.py", line 31
    pdf = for url in parser.urls:
            ^
SyntaxError: invalid syntax
bash-3.2$ python tryagain.py
